NO ./texture/NO.xpm
SO ./texture/SO.xpm
WE ./texture/WE.xpm
EA ./texture/EA.xpm

F 30,30,30
C 0,0,225

        1111111111
 1111111000000000011111111
100000000000000000000000001
100000000000000011111111111
100000000000000010000000001
100E00000000000010000000001
100000000000000011111111111
100000000000000000000000001
100000000000000000000000001
100000000000000000000000001
100000000000000000000000001
100111111111111111111111001
100000000000000000000000001
100000000000000000000000001
100000000000000000000000001
100000000111111111000000001
1000000001       1000000001
 11111111         11111111
